5 5
1 1 1 1 1
1 1 2 1 1
1 2 X 2 1
1 1 2 1 1
1 1 1 1 1
START 0 0
GOAL 4 4
